珠海市	亚热带季风气候
莆田市	亚热带海洋性季风气候
日照市	暖温带半湿润性季风气候
大连市	海洋性温带暖热性气候
迁安市	暖温带大陆性季风气候
深圳市	亚热带海洋性季风气候
乌兰察布市	中温带大陆性季风气候
桦甸市	中温带湿润气候
漳州市	亚热带季风性湿润气候
北海市	亚热带季风气候
格尔木市	大陆高原气候
厦门市	亚热带海洋性季风气候
贵阳市	亚热带湿润温和型气候
牡丹江市	温带大陆性季风气候
开封市	暖温带大陆性季风气候
高雄市	热带季风气候
酒泉市	温带大陆性荒漠气候
呼和浩特市	中温带大陆性季风气候
仙桃市	亚热带季风气候
赤峰市	中温带半干旱大陆性季风气候区
常熟市	亚热带季风性气候
信宜市	亚热带季风气候
东阳市	亚热带季风气候
河津市	暖温带半湿润大陆性季风气候
三明市	亚热带海洋性季风气候
临江市	温带季风气候
沧州市	暖温带半干旱半湿润季风气候
南充市	亚热带季风湿润性气候
普宁市	南亚热带季风气候
阜阳市	温带季风气候
兰州市	温带大陆性气候
长沙市	亚热带季风性湿润气候
扎兰屯市	温带半湿润大陆性季风气候区
中山市	亚热带季风气候
芜湖市	亚热带湿润季风气候
富锦市	温带大陆性气候
莱芜市	暖温带大陆性季风气候
杭州市	亚热带季风性气候
盘锦市	温带季风性气候
遂宁市	亚热带湿润季风气候
井冈山市	亚热带季风气候
濮阳市	温带季风性气候
通辽市	温带大陆性气候
陇南市	亚热带向暖温带过渡区
恩施市	中亚热带季风型山地湿润性气候
北安市	中温带大陆性季风气候
曲阜市	暖温带大陆性季风气候
成都市	亚热带季风气候
宜兴市	亚热带季风气候
德兴市	亚热带季风性湿润气候
商洛市	暖温带半湿润季风山地气候
海口市	热带海洋性季风气候
马鞍山市	亚热带湿润季风气候
永州市	亚热带季风气候
雅安市	亚热带季风气候
亳州市	亚热带季风气候
乳山市	暖温带东亚季风型大陆性气候
霸州市	温带大陆性季风性气候
开远市	亚热带季风气候
铜川市	大陆性季风气候
灵武市	中温带大陆性气候
桐城市	亚热带气候
汕头市	亚热带季风气候
沈阳市	温带季风气候
东兴市	亚热带季风气候
荥阳市	温带季风气候
湖州市	亚热带湿润季风气候
岳阳市	亚热带季风气候
乌鲁木齐市	温带大陆性气候
桃园市	亚热带季风气候
塔城市	中温带大陆性干旱气候
阿尔山市	寒温带大陆性季风气候
台北市	热带季风气候
台北市 亚热带季风气候
高邮市	亚热带温润季风气候
鄂州市	亚热带季风气候
南宫市	暖温带亚湿润大陆性季风型气候
衢州市	亚热带季风气候
涟源市	大陆性中亚热带季风湿润气候
日喀则市	高原山地气候
萍乡市	亚热带季风气候
常州市	亚热带季风气候
西安市	温带季风气候
汾阳市	温带大陆性气候
包头市	半干旱中温带大陆性季风气候
武安市	温带大陆性季风气候
巴中市	亚热带大陆性湿润季风气候
珲春市	中温带海洋性季风气候
绍兴市	亚热带季风气候
淮南市	亚热带季风气候
公主岭市	温带季风气候
枝江市	亚热带季风气候
齐齐哈尔市	中温带大陆性季风气候
盐城市	亚热带季风气候
阿图什市	暖温带大陆性干旱气候
德州市	温带大陆性季风气候
九江市	亚热带季风气候
吉林市	温带季风气候
福州市	亚热带海洋性季风气候
南雄市	亚热带季风气候
抚顺市	大陆性季风气候
泉州市	亚热带海洋性季风气候
湘乡市	亚热带季风性湿润气候
如皋市	北亚热带海洋性季风气候
张家口市	温带大陆性气候
三河市	温带季风气候
耒阳市	亚热带季风性湿润气候区
兰溪市	亚热带季风气候
镇江市	北亚热带季风气候
吐鲁番市	大陆性暖温带荒漠气候
毕节市	北亚热带湿润季风气候
兴平市	暖温带大陆性季风气候
乐山市	亚热带季风气候
安陆市	亚热带季风气候
洛阳市	温带大陆性气候
商丘市	温带大陆季风性气候
常德市	中亚热带湿润季风气候
昆明市	亚热带高原季风气候
福鼎市	中亚热带季风气候
韶关市	亚热带季风气候
石首市	亚热带季风气候
徐州市	温带季风气候
樟树市	亚热带季风气候
绵阳市	亚热带季风性湿润气候
瑞昌市	南亚热带季风气候
揭阳市	亚热带季风气候
苏州市	亚热带季风性湿润气候
邵武市	亚热带湿润性气候
牙克石市	寒温带半湿润大陆性季风气候区
长治市	暖温带半湿润大陆性季风气候
遵化市	暖温带大陆性季风气候
密山市	中温带大陆性季风气候
邯郸市	温带大陆性季风气候
嘉兴市	亚热带季风气候
高州市	亚热带季风气候
固原市	温带大陆性气候
儋州市	热带季风气候
宜宾市	亚热带季风气候
韩城市	冬季寒冷少雪，夏季炎热多雨（温带季风气候）
丽水市	亚热带季风气候
南平市	亚热带湿润性气候
阆中市	亚热带季风气候
台州市	亚热带季风气候
莱西市	温带海洋性季风气候
津市	中亚热带湿润季风气候
大庆市	温带季风气候
登封市	温带季风气候
临汾市	温带大陆性气候
赣州市	亚热带季风气候
宁乡市	亚热带季风性湿润气候
通化市	北温带大陆性季风气候
大同市	大陆性半干旱季风气候
湘潭市	亚热带季风性湿润气候
舟山市	亚热带季风气候
兴城市	温带季风性气候
延安市	内陆干旱半干旱气候
渭南市	温带大陆性气候
新乐市	温带季风气候
白银市	中温带半干旱气候
铜陵市	亚热带湿润季风气候
五常市	中温带大陆性季风气候
北京市	北温带季风气候
温州市	中亚热带季风气候
同江市	大陆性季风气候
临海市	亚热带季风气候
吕梁市	温带大陆性气候
永康市	亚热带季风气候
虎林市	北温带气候
林芝市	高原气候
绵竹市	亚热带季风气候
临夏市	温带大陆性气候
湛江市	热带季风气候、亚热带季风性气候
华蓥市	亚热带季风气候
阿克苏市	暖温带大陆性气候
太仓市	亚热带季风气候
上海市	亚热带季风气候
锦州市	温带季风性气候
池州市	气候温暖，四季分明
新沂市	温带季风气候
三亚市	热带海洋性季风气候
大冶市	亚热带
敦化市	温带大陆季风气候
临沂市	温带季风性气候
应城市	亚热带季风气候
邛崃市	亚热带湿润气候
任丘市	东部季风区暖温带半湿润气候
铁力市	中温带大陆性季风气候
驻马店市	亚热带向暖温带过渡地区
广汉市	亚热带季风性湿润气候
瑞安市	亚热带海洋型季风气候
华阴市	温带大陆性气候
楚雄市	北亚热带季风气候区
临湘市	山湖交融，气候湿润，四季分明
瑞金市	亚热带季风性湿润气候
玉林市	亚热带季风气候
莱州市	北温带东亚季风区大陆性气候
文山市	亚热带气候
海安市	亚热带季风气候
焦作市	暖温带亚湿润季风气候
那曲市	高原气候
济南市	暖温带半湿润大陆性季风气候
凌源市	北温带大陆性季风气候
拉萨市	高原山地气候
青州市	温带季风性气候
朝阳市	北温带大陆性季风气候
兴宁市	亚热带季风气候
界首市	暖温带半湿润季风气候
宜春市	中亚热带季风气候区
腾冲市	热带季风气候
阿拉山口市	大陆性温带气候
定西市	中温带半干旱区
建德市	亚热带季风性气候
庆阳市	温带大陆性季风气候
佳木斯市	温带大陆性气候
吴川市	亚热带季风气候为主
潜江市	亚热带季风性湿润气候
随州市	亚热带季风气候
本溪市	温带大陆性季风气候
庄河市	温带季风性气候
太原市	温带季风性气候
什邡市	亚热带季风气候
江门市	亚热带季风气候
肇庆市	亚热带季风气候
金华市	亚热带季风气候
侯马市	温带季风气候
宿迁市	温带季风性气候
重庆市	亚热带季风性湿润气候
漠河市	寒温带大陆性季风气候
尚志市	中温带大陆性季风气候
句容市	亚热带季风气候
武穴市	亚热带季风性湿润气候
天长市	北亚热带向暖温带过渡性气候
临沧市	亚热带山地季风气候
汉川市	亚热带季风气候
银川市	中温带大陆性气候
南阳市	季风大陆半湿润气候
铁岭市	中温带大陆性季风气候
岑溪市	亚热带季风气候
许昌市	温带季风性气候
满洲里市	寒温带气候
北流市	南亚热带季风气候
张掖市	夏季干燥，温度较低
松原市	中温带大陆性季风气候
简阳市	亚热带季风气候
江阴市	亚热带季风气候
安阳市	暖温带大陆性季风气候
唐山市	暖温带大陆性季风气候
西昌市	亚热带高原季风气候
乐昌市	亚热带季风气候
河池市	亚热带季风气候
宣城市	亚热带湿润季风气候
中卫市	温带大陆性气候
都匀市	亚热带季风湿润气候
晋中市	温带季风气候
天水市	暖温带半湿润半干旱气候
辽源市	温带季风性气候
枣庄市	温带大陆性季风气候
桐乡市	亚热带季风气候
四平市	中温带湿润季风气候区
奎屯市	温带大陆性干旱气候
周口市	亚热带季风气候
文昌市	热带季风岛屿型气候
万宁市	热带季风气候
无锡市	亚热带季风气候
益阳市	亚热带大陆性季风湿润气候
清远市	亚热带季风气候
汕尾市	亚热带季风气候
偃师市	亚热带季风气候
铜仁市	亚热带季风气候
咸阳市	温带大陆性季风型气候
西宁市	高原大陆性气候
荆州市	亚热带季风气候
宁国市	亚热带季风气候
泰安市	温带半湿润大陆性季风气候
靖西市	亚热带季风气候
丹阳市	亚热带季风气候
营口市	暖温带大陆性季风气候
延吉市	中温带半湿润气候区
怀化市	亚热带季风性湿润气候
鞍山市	温带季风气候
宜昌市	亚热带季风性湿润气候
孝感市	亚热带季风气候
廉江市	亚热带（或热带）季风气候
平凉市	陇东温和半湿润农业气候区
黄冈市	亚热带季风气候
桂林市	亚热带季风气候
惠州市	亚热带海洋性季风气候
哈尔滨市	中温带大陆性季风气候
辽阳市	温带湿润性季风气候
自贡市	中亚热带湿润季风气候区
东台市	亚热带和暖温带季风气候
邢台市	温带季风气候
绥化市	中温带大陆性季风气候
青岛市	温带季风气候
靖江市	亚热带季风气候
山南市	温带干旱性高原气候
郴州市	亚热带季风气候
遵义市	亚热带季风性湿润气候
英德市	亚热带季风气候
老河口市	亚热带季风气候
江油市	中亚热带湿润季风气候
南宁市	亚热带季风气候
泰州市	亚热带季风气候
台山市	亚热带海洋性季风气候
醴陵市	亚热带季风气候
合肥市	亚热带季风气候
大理市	低纬度高原季风气候
永安市	亚热带季风气候
慈溪市	亚热带季风气候
保山市	温带气候
内江市	亚热带季风气候
襄阳市	亚热带季风气候
兴化市	亚热带温润季风气候
丹江口市	光照充足、雨热同季、相对湿度大
和龙市	温带季风半湿润气候
安庆市	亚热带季风性湿润气候
天门市	亚热带季风气候
高平市	温带季风气候
克拉玛依市	温带沙漠气候
呼伦贝尔市	温带季风气候和温带大陆性气候
荣成市	暖温带季风型湿润气候区
汉中市	北亚热带湿润季风气候
寿光市	暖温带季风区大陆性气候
北镇市	温带季风气候
溧阳市	亚热带季风气候
介休市	温带季风气候
喀什市	暖温带大陆性干旱气候
河间市	温带季风气候
蚌埠市	亚热带季风气候
晋城市	暖温带半湿润大陆性季风气候
扬州市	亚热带季风性气候
阜新市	大陆性气候
安顺市	亚热带季风气候
威海市	北暖温带季风型大陆性气候
抚州市	亚热带季风气候
钦州市	带海洋性的热带季风气候
娄底市	中亚热带大陆性季风湿润气候
东港市	温带湿润地区大陆性季风气候
黑河市	寒温带大陆性季风气候
石河子市	大陆性高原气候
玉门市	大陆性中温带干旱气候
广州市	亚热带季风气候
梅州市	亚热带季风气候
宿州市	北亚热带和暖温带过渡区
建瓯市	亚热带湿润性气候
玉溪市	亚热带季风气候
承德市	温带季风气候
潜山市	北亚热带季风气候
阳江市	亚热带季风气候
烟台市	温带季风气候
博乐市	大陆性温带干旱气候
邵阳市	亚热带季风性湿润气候
龙口市	温带季风气候
凤城市	温带季风气候
宜都市	亚热带季风气候
淮北市	暖温带半湿润季风气候
和田市	温带大陆性气候
伊春市	中温带大陆性季风气候
晋江市	亚热带季风气候
辉县市	暖温带大陆性季风气候
保定市	暖温带大陆性气候
丽江市	温带气候
眉山市	亚热带季风气候
海门市	亚热带季风气候
潍坊市	北温带季风区
丹东市	中温带和暖温带湿润性季风气候
麻城市	亚热带季风气候
台中市	副热带气候、亚热带气候
南通市	北亚热带和暖温带季风气候
潮州市	亚热带海洋性季风气候
景洪市	热带雨林气候
南昌市	亚热带季风湿润气候
济宁市	暖温带季风气候
泰兴市	亚热带季风气候
永城市	暖温带季风性半湿润气候
东莞市	亚热带季风气候
图们市	温带季风气候
晋州市	暖温带大陆性季风气候
石嘴山市	温带大陆性气候
天津市	暖温带半湿润季风性气候
长春市	温带季风气候
集安市	温带季风气候
龙泉市	亚热带季风气候
榆林市	温带半干旱大陆性季风气候
石家庄市	温带季风气候
平度市	温带季风气候
昌吉市	大陆性干旱气候
福清市	亚热带季风气候
秦皇岛市	暖温带半湿润大陆性季风气候
南京市	亚热带季风气候
化州市	亚热带季风气候
邳州市	温带季风气候
开原市	北温带季风型大陆性气候
宜城市	亚热带季风性湿润气候
平湖市	亚热带季风性湿润气候
龙岩市	亚热带季风气候
禹城市	暖温带大陆季风气候
阿勒泰市	温带大陆性气候
曲靖市	亚热带高原季风气候
衡水市	温带季风气候
德惠市	北温带大陆性季风气候
枣阳市	亚热带大陆性季风气候
兴义市	亚热带湿润温和型气候
浏阳市	亚热带季风湿润气候
仁怀市	亚热带湿润季风气候
蒙自市	亚热带季风气候
梧州市	亚热带季风气候
当阳市	亚热带季风性湿润气候
济源市	暖温带大陆性季风气候
六盘水市	亚热带湿润季风气候
穆棱市	温带大陆性季风气候
宝鸡市	温带季风气候
贵溪市	亚热带季风气候
百色市	亚热带季风气候
高密市	暖温带半湿润季风气候
栖霞市	温带季风气候
昭通市	干燥季风气候
广元市	亚热带湿润季风气候
启东市	北亚热带湿润气候区
开平市	亚热带季风气候
黄石市	亚热带季风气候
茂名市	亚热带季风性湿润气候
南安市	亚热带海洋性季风气候
库尔勒市	暖温带大陆性干旱气候
张家界市	中亚热带山原型季风性湿润气候
滁州市	北亚热带湿润性季风气候
诸暨市	亚热带季风气候
沁阳市	温带大陆性季风气候
泸州市	亚热带季风性湿润气候
吉安市	亚热带季风气候
磐石市	温带大陆性季风天气
新郑市	暖温带大陆性季风气候
连云港市	温带季风气候
三门峡市	暖温带大陆性季风气候
仪征市	北亚热带季风气候
运城市	暖温带半湿润大陆性季风气候
青铜峡市	中温带大陆性气候
桂平市	亚热带季风气候
项城市	暖温带和亚热带季风气候过渡区
资阳市	中亚热带湿润季风气候区
新余市	亚热带季风气候
河源市	亚热带季风性气候
淮安市	暖温带向亚热带的过渡性气候
台南市	热带和亚热带气候
武威市	温带大陆性气候
白城市	温带大陆性气候
柳州市	亚热带季风气候
连州市	亚热带季风气候
东宁市	温带大陆性季风气候
温岭市	亚热带季风气候
讷河市	温带季风气候
诸城市	北温带季风性气候
宁波市	亚热带季风气候
衡阳市	亚热带季风气候
资兴市	亚热带温湿气候
彭州市	亚热带湿润气候
丰城市	气候温和，四季分明
荆门市	亚热带季风气候
余姚市	亚热带季风性气候
